wwwwwwwwwwwww
wQ..........w
w...........w
w...........w
www.w2..wwwww
w.......w.g.w
w.2.........w
w.....2.....w
wwwwwwwwwwwww
